about	approximately
abstract	summary
accomplish	achieve
accumulate	build up
administer	manage
admit	confess
almost	nearly
animated	lively
annoy	irritate
answer	reply
anyway	besides
apparent	obvious
appear	seem
applicable	relevant
appreciable	considerable
ardour	passion
arise	occur
aromatic	fragrant
arrive	reach
artful	crafty
association	organization
assure	guarantee
attractive	appealing
away	absent
awful	terrible
backbone	spine
backside	behind
bad	poor
ballot	poll
bear on sth.	affect
beat	defeat
becoming	fitting
begin	start
behave	act
believable	plausible
belly	stomach
bendy	flexible
beneficiant	generous
beneficial	favourable
bid	tender
bizarre	weird
blameless	innocent
bloodbath	massacre
bloodless	cold
branch	department
brave	courageous
bring back	reintroduce
bring on	cause
bring up	raise
brow	forehead
bum	backside
business	commerce
busy	engaged
candy	sweet
categorize	classify
categorise 	classify
charter	constitution
cheesy	corny
chiefly	mainly
choosy	picky
chop	cut
chorus	refrain
citation	quotation
cite	quote
class	lesson
clerk	receptionist
clever	intelligent
close	shut
coiffure	hairstyle
collapse	break down
collect	gather
comfort	consolation
comic	comedian
commencement	graduation
complete	total
completely	totally
concord	harmony
condemn	sentence
confederate	accomplice
confine	restrict
conflict	clash
conform	comply
confuse	mix up
connect	associate
considerate	thoughtful
constancy	fidelity
constant	fixed
constitution	structure
construction	interpretation
consult	refer to
contemporary	modern
continuous	continual
contrary	opposite
convention	conference
convey	communicate
cope	manage
correct	right
couch	sofa
crook	criminal
crusade	campaign
cube	dice
curative	healing
curler	roller
cussed	stubborn
dash	sprint
daybreak	dawn
deceptive	misleading
decontrol	deregulate
dedicated	committed
deduce	infer
defective	faulty
deliberate	planned
deliberately	intentionally
delicate	fragile
demostrate	protest
denationalize	privatize
denationalise 	privitize
denims	jeans
denote	indicate
deprave	corrupt
depraved	wicked
desert	abandon
deserted	abandoned
destiny	fate
detached	indifferent
devil	satan
dicy	risky
differentiate	distinguish
diminish	decrease
disadvantaged	deprived
disagreeable	unpleasant
disappear	vanish
disaster	catastrophe
disclaim	deny
disclose	reveal
discount	reduction
disgrace	shame
domesticate	cultivate
dossier	file
dubious	doubtful
dull	stupid
eager	keen
earth	soil
ecocnomic	profitable
egocentric	selfish
elevate	raise
emphasise	stress
emphasize 	stress
encounter	come across
enormous	huge
enquire	investigate
equity	fairness
especially	particularly
essential	fundamental
establish	set up
evaluate	assess
everlasting	eternal
exactly	precisely
except	apart from
expire	run out
explode	blow up
extra	additional
fabricate	manufacture
famous	renowned
fanatic	enthusiast
fantastic	brilliant
float	drift
fool	idiot
foolish	silly
forehead	brow
foretell	predict
formerly	previously
fortunate	lucky
foxy	cunning
foyer	lobby
fragrance	perfume
French	vinaigrette
function	operate
garbage	rubbish
garbagecan 	trashcan 
gay	homosexual
glitter	sparkle
grab	seize
grasping	greedy
gratis	free of charge
gratuity	tip
gravestone	headstone
grouse	grumble
gut	intestine
hall	corridor
handsome	good-looking
hang-out	haunt
happily	fortunately
hard	tough
hashish	cannabis
hawk	peddle
hazard	endanger
hearsay	rumour
hermetic	airtight
highbrow	intellectual
hint	trace
hole	gap
home	domestic
homicide	murder
housebreaking	burglary
hunger	starvation
hurry	rush
hypothesis	speculation
idler	loafer
if	whether
ignore	disregard
illiberal	intolerant
illuminate	clarify; light up
illustrate	demonstrate
imagine	"suppose, assume"
imitate	mimic
immediate	instant
immobile	motionless
immoderate	excessive
immodest	conceited
impact	affect
impartial	neutral
impasse	deadlock
impassive	emotionless
impeach	question
impediment	obstacle
imperative	vital
impolite	rude
incidentally	by the way
inconsiderate	thoughtless
indisputable	indeniable
infamous	notorious
infantile	childish
infect	contaminate
inflexible	rigid
inflow	influx
informal	casual
infrequent	rare
inheritor	heir
innocent	harmless
insolvent	bancrupt
inspect	examine
instinct	intuition
instructions	directions
insufferable	unbearable
insufficient	inadequate
insupportable	intolerable
insurgent	rebel
intellectual	mental
intend	mean
intensify	heighten
interplay	interaction
inventory	stock
invoice	bill
ivolve	entail
isolated	loney
jealous	envious
joy	delight
knowingly	deliberately
lacking	missing
last	final
leading	main
learn	memorize
legitimate	"valid, lega"
lethal	deadly
liveable	habitable
livid	furious
loopy	crazy
lousy	awful
lucid	clear
mackintosh	waterproof coat
madness	insanity
magician	conjuror
magistrate	Justice of the Peace
magnify	exaggerate
maintain	preserve
manmade	artifical
mannequin	model
material	fabric
matters	things
maybe	"perhaps, possibly"
in the meantime	meanwhile
measure	degree
meeting	assembly
mendacity	lying
merciless	cruel
middleman	intermediary
midway	halfway
migrate	emigrate
mild	gentle
mimic	imitate
mind	intellect
mindless	senseless
minimize	play down
mirror	reflect
misconceive	misunderstand
miserable	depressing
misery	distress
misread	misinterpret
missing	lost
mistrust	distrust
mo 	moment
moderately	reasonably
modern	contemporary
more and more	increasingly
moreover	in addition
movie	film
murderer	assassin
naked	bare
nameless	anonymous
napkin	serviette
narrate	relate
a narrative	a story
a native	a local
near	approach
necessary	essential
nightfall	dusk
nobility	the Aristocracy
nominate	appoint
non-stop	continuous
noon	midday
noted	famous
notify	inform
notwithstanding	however
nugatory	worthless
obdurate	stubborn
object	thing
obligatory	compulsory
oblique	indirect
omnipotent	all-powerful
obsolete	out of date
off-season	low season
operate	function
organic	biological
ornament	decoration
outside	external
overhaul	overtake
overlook	miss
overseas	abroad
oversee	supervise
painting	portray
paper money	notes
particular	specific
passable	satisfactory
pattern	sample
peaceable	peaceful
perception	insight
phantasm	illusion
pocket book	notebook
poisonous	toxic
possibility	opportunity
post-mortem	autopsy
practically	virtually
praise	compliment
precedence	priority
precept	principle
precis	summary
pressing	urgent
previous	preceding
priority	precedence
prompt	immediate
prosperous	affluent
provide	supply
provided	if
put sth. back	postpone
quake	tremble
quite	fairly
reasonable	fair
receive	get
refrain	chorus
reliable	dependable
religious	devout
remainder	the rest
remark	comment
reminiscence	memory
remorse	regret
remoted	isolated
removable	detachable
renew	resume
renounce	give up
repute	reputation
respond	reply
revolting	disgusting
rubbish	nonsense
rude	impolite
rue	regret
sacristy	vestry
satisfied	convinced
scarcity	shortage
scrumptious	delicious
second	moment
select	choose
selection	choice
self-assured	confident
signal	sign
significant	meaningful
silly	foolish
sincere	honest
skull	cranium
soiled	dirty
spotlight	highlight
stable	steady
steady	regular
stupid	silly
substantially	considerably
suggest	propose
sundown	sunset
sunrise	dawn
sure	certain
surroundings	environment
survive	outlive
symbolize	represent
tailored	tailor-made
temper	mood
terror	terrorism
testament	testimony
today	nowadays
torpid	lethargic
touchdown	landing
touchy	sensitive
transform	convert
transitory	temporary
transparent	obvious
trustworthy	reliable
twister	tornado
twosome	pair
ultimate	final
uncared for	neglected
uncommon	unusual
uncooked	raw
undeniable	indisputable
understandable	comprehensible
unforeseen	unexpected
unfortunate	unlucky
unhurt	unharmed
uninjured	unhurt
unlawful	illegal
unmarried	single
unstated	unspoken
untimely	premature
untrue	unfaithful
unusual	strange
unvoiced	voiceless
uprising	rebellion
usually	generally
vacancy	emptiness
vacuum	hoover
vague	indistinct
vain	useless
valueless	worthless
vanquish	conquer
vary	differ
vast	huge
virtue	advantage
visualize	imagine
warranty	guarantee
well mannered	polite
well timed	timely
winery	vineyard
withstand	resist
zenith	peak
